[
{
    "name": "Level 3: Simple Push",
    "level": [
      [2,2,2,2,2,2,2,2,2,2,2,2],
      [2,0,0,0,0,0,0,0,0,0,0,2],
      [2,0,0,0,0,0,0,0,0,0,0,2],
      [2,0,1,3,0,0,0,0,4,0,0,2],
      [2,0,0,0,0,0,0,0,0,0,0,2],
      [2,0,0,0,0,0,0,0,0,0,0,2],
      [2,0,0,0,0,0,0,0,0,0,0,2],
      [2,2,2,2,2,2,2,2,2,2,2,2]
    ],
    "start_player": [2, 3]
  },
  {
    "name": "Level 4: Wall Block",
    "level": [
      [2,2,2,2,2,2,2,2,2,2,2,2],
      [2,0,0,0,0,0,0,0,0,0,0,2],
      [2,0,0,0,0,0,0,0,0,0,0,2],
      [2,0,1,0,0,0,0,0,0,0,0,2],
      [2,0,2,3,0,0,0,0,4,0,0,2],
      [2,0,0,0,0,0,0,0,0,0,0,2],
      [2,0,0,0,0,0,0,0,0,0,0,2],
      [2,2,2,2,2,2,2,2,2,2,2,2]
    ],
    "start_player": [2, 4]
  },
  {
    "name": "Level 5: Double Push",
    "level": [
      [2,2,2,2,2,2,2,2,2,2,2,2],
      [2,0,0,0,0,0,0,0,0,0,0,2],
      [2,0,0,0,0,0,0,0,0,0,0,2],
      [2,0,1,3,3,0,0,4,4,0,0,2],
      [2,0,0,0,0,0,0,0,0,0,0,2],
      [2,0,0,0,0,0,0,0,0,0,0,2],
      [2,0,0,0,0,0,0,0,0,0,0,2],
      [2,2,2,2,2,2,2,2,2,2,2,2]
    ],
    "start_player": [2, 3]
  },
  {
    "name": "Level 6: Tight Space",
    "level": [
      [2,2,2,2,2,2,2,2,2,2,2,2],
      [2,0,0,0,0,0,0,0,0,0,0,2],
      [2,2,2,2,2,2,0,0,0,0,0,2],
      [2,0,1,0,0,2,0,3,0,4,0,2],
      [2,0,0,0,0,2,0,0,0,0,0,2],
      [2,0,0,0,0,0,0,0,0,0,0,2],
      [2,0,0,0,0,0,0,0,0,0,0,2],
      [2,2,2,2,2,2,2,2,2,2,2,2]
    ],
    "start_player": [2, 3]
  },
  {
    "name": "Level 7: Multiple Targets",
    "level": [
      [2,2,2,2,2,2,2,2,2,2,2,2],
      [2,0,0,0,0,0,0,0,0,0,0,2],
      [2,0,3,0,3,0,0,0,0,0,0,2],
      [2,0,0,1,0,0,0,0,0,0,0,2],
      [2,0,4,0,4,0,0,0,0,0,0,2],
      [2,0,0,0,0,0,0,0,0,0,0,2],
      [2,0,0,0,0,0,0,0,0,0,0,2],
      [2,2,2,2,2,2,2,2,2,2,2,2]
    ],
    "start_player": [3, 3]
  },
  {
    "name": "Level 8: L-Shape",
    "level": [
      [2,2,2,2,2,2,2,2,2,2,2,2],
      [2,0,0,0,0,0,0,0,0,0,0,2],
      [2,0,2,2,2,2,2,2,2,0,0,2],
      [2,0,2,0,0,0,0,0,2,0,0,2],
      [2,0,2,3,0,0,0,0,2,0,0,2],
      [2,0,2,0,0,1,0,0,2,4,0,2],
      [2,0,2,2,2,2,2,2,2,0,0,2],
      [2,2,2,2,2,2,2,2,2,2,2,2]
    ],
    "start_player": [5, 5]
  },
  {
    "name": "Level 9: Corner Entry",
    "level": [
      [2,2,2,2,2,2,2,2,2,2,2,2],
      [2,0,0,0,0,0,0,0,0,0,0,2],
      [2,0,2,2,2,2,2,2,2,2,0,2],
      [2,0,2,0,0,0,0,0,0,2,0,2],
      [2,0,2,0,3,0,0,0,0,2,0,2],
      [2,0,2,0,0,0,0,0,0,2,1,2],
      [2,0,2,2,2,2,2,2,2,2,4,2],
      [2,2,2,2,2,2,2,2,2,2,2,2]
    ],
    "start_player": [10, 5]
  },
  {
    "name": "Level 10: Maze-like",
    "level": [
      [2,2,2,2,2,2,2,2,2,2,2,2],
      [2,0,0,0,2,0,0,0,0,0,0,2],
      [2,0,2,0,2,0,2,2,2,2,0,2],
      [2,0,2,0,0,0,0,0,0,2,0,2],
      [2,0,2,2,2,2,2,2,0,2,3,2],
      [2,0,0,0,0,0,0,2,0,0,4,2],
      [2,0,1,0,0,0,0,2,2,2,2,2],
      [2,2,2,2,2,2,2,2,2,2,2,2]
    ],
    "start_player": [2, 6]
  },
  {
    "name": "Level 11: Two Boxes Parallel",
    "level": [
      [2,2,2,2,2,2,2,2,2,2,2,2],
      [2,0,0,0,0,0,0,0,0,0,0,2],
      [2,0,3,0,0,0,0,0,0,0,0,2],
      [2,0,0,1,0,0,0,0,0,0,0,2],
      [2,0,3,0,0,0,0,0,4,0,0,2],
      [2,0,0,0,0,0,0,0,4,0,0,2],
      [2,0,0,0,0,0,0,0,0,0,0,2],
      [2,2,2,2,2,2,2,2,2,2,2,2]
    ],
    "start_player": [3, 3]
  },
  {
    "name": "Level 12: Diagonal Push",
    "level": [
      [2,2,2,2,2,2,2,2,2,2,2,2],
      [2,0,0,0,0,0,0,0,0,0,0,2],
      [2,0,0,0,0,0,0,0,0,0,0,2],
      [2,0,1,0,0,0,0,0,0,0,0,2],
      [2,0,0,3,0,0,0,0,0,0,0,2],
      [2,0,0,0,4,0,0,0,0,0,0,2],
      [2,0,0,0,0,0,0,0,0,0,0,2],
      [2,2,2,2,2,2,2,2,2,2,2,2]
    ],
    "start_player": [2, 3]
  },
  {
    "name": "Level 13: U-Turn",
    "level": [
      [2,2,2,2,2,2,2,2,2,2,2,2],
      [2,0,0,0,0,0,0,0,0,0,0,2],
      [2,0,2,2,2,2,2,2,2,2,0,2],
      [2,0,2,0,0,0,0,0,0,2,0,2],
      [2,0,2,0,3,0,0,0,0,2,0,2],
      [2,0,2,0,0,0,0,0,0,2,1,2],
      [2,0,2,2,2,2,2,2,2,2,4,2],
      [2,2,2,2,2,2,2,2,2,2,2,2]
    ],
    "start_player": [10, 5]
  },
  {
    "name": "Level 14: Narrow Passage",
    "level": [
      [2,2,2,2,2,2,2,2,2,2,2,2],
      [2,0,0,0,0,0,0,0,0,0,0,2],
      [2,2,2,2,2,2,2,2,2,2,0,2],
      [2,1,0,0,0,0,0,0,0,2,0,2],
      [2,2,2,2,2,2,2,2,0,2,3,2],
      [2,0,0,0,0,0,0,2,0,0,4,2],
      [2,0,0,0,0,0,0,2,2,2,2,2],
      [2,2,2,2,2,2,2,2,2,2,2,2]
    ],
    "start_player": [1, 3]
  },
  {
    "name": "Level 15: Boxes in a Row",
    "level": [
      [2,2,2,2,2,2,2,2,2,2,2,2],
      [2,0,0,0,0,0,0,0,0,0,0,2],
      [2,0,3,3,3,0,0,0,0,0,0,2],
      [2,0,1,0,0,0,0,0,0,0,0,2],
      [2,0,4,4,4,0,0,0,0,0,0,2],
      [2,0,0,0,0,0,0,0,0,0,0,2],
      [2,0,0,0,0,0,0,0,0,0,0,2],
      [2,2,2,2,2,2,2,2,2,2,2,2]
    ],
    "start_player": [2, 3]
  },
  {
    "name": "Level 16: Obstacle Course",
    "level": [
      [2,2,2,2,2,2,2,2,2,2,2,2],
      [2,0,0,0,0,0,0,0,0,0,0,2],
      [2,0,2,2,2,0,2,2,2,2,0,2],
      [2,0,0,1,0,0,0,0,0,0,0,2],
      [2,0,2,3,2,0,2,3,2,0,4,2],
      [2,0,0,0,0,0,0,0,0,0,4,2],
      [2,0,2,2,2,0,2,2,2,2,2,2],
      [2,2,2,2,2,2,2,2,2,2,2,2]
    ],
    "start_player": [3, 3]
  },
  {
    "name": "Level 17: Inner Walls",
    "level": [
      [2,2,2,2,2,2,2,2,2,2,2,2],
      [2,0,0,0,0,0,0,0,0,0,0,2],
      [2,0,2,2,2,2,2,2,2,0,0,2],
      [2,0,2,1,0,0,0,0,2,0,0,2],
      [2,0,2,0,3,0,0,0,2,0,0,2],
      [2,0,2,0,0,0,0,0,2,4,0,2],
      [2,0,2,2,2,2,2,2,2,0,0,2],
      [2,2,2,2,2,2,2,2,2,2,2,2]
    ],
    "start_player": [3, 3]
  },
  {
    "name": "Level 18: Multiple Boxes",
    "level": [
      [2,2,2,2,2,2,2,2,2,2,2,2],
      [2,0,0,0,0,0,0,0,0,0,0,2],
      [2,0,3,0,3,0,0,0,0,0,0,2],
      [2,0,0,1,0,0,0,0,0,0,0,2],
      [2,0,3,0,3,0,0,0,4,4,0,2],
      [2,0,0,0,0,0,0,0,0,0,0,2],
      [2,0,0,0,0,0,0,0,0,0,0,2],
      [2,2,2,2,2,2,2,2,2,2,2,2]
    ],
    "start_player": [3, 3]
  },
  {
    "name": "Level 19: Exit Strategy",
    "level": [
      [2,2,2,2,2,2,2,2,2,2,2,2],
      [2,0,0,0,0,0,0,0,0,0,0,2],
      [2,0,2,2,2,2,2,2,2,2,0,2],
      [2,0,2,1,0,0,0,0,0,2,0,2],
      [2,0,2,0,3,0,0,0,0,2,0,2],
      [2,0,2,0,0,0,0,0,0,2,4,2],
      [2,0,2,2,2,2,2,2,2,2,0,2],
      [2,2,2,2,2,2,2,2,2,2,2,2]
    ],
    "start_player": [3, 3]
  },
  {
    "name": "Level 20: The Grand Finale",
    "level": [
      [2,2,2,2,2,2,2,2,2,2,2,2],
      [2,0,0,0,0,0,0,0,0,0,0,2],
      [2,0,2,3,2,3,2,3,2,0,0,2],
      [2,0,0,0,0,0,0,0,0,1,0,2],
      [2,0,2,4,2,4,2,4,2,0,0,2],
      [2,0,0,0,0,0,0,0,0,0,0,2],
      [2,0,0,0,0,0,0,0,0,0,0,2],
      [2,2,2,2,2,2,2,2,2,2,2,2]
    ],
    "start_player": [9, 3]
  }
  [
  {
    "name": "Level 1: The Basics",
    "level": [
      [2,2,2,2,2,2,2,2,2,2,2,2],
      [2,0,0,0,0,0,0,0,0,0,0,2],
      [2,0,0,0,0,0,0,0,0,0,0,2],
      [2,0,0,3,0,0,0,0,0,0,0,2],
      [2,0,0,1,0,0,0,4,0,0,0,2],
      [2,0,0,0,0,0,0,0,0,0,0,2],
      [2,0,0,0,0,0,0,0,0,0,0,2],
      [2,2,2,2,2,2,2,2,2,2,2,2]
    ],
    "start_player": [3, 4]
  },
  {
    "name": "Level 2: Cornered Box",
    "level": [
      [2,2,2,2,2,2,2,2,2,2,2,2],
      [2,0,0,0,0,0,0,0,0,0,0,2],
      [2,0,3,0,0,0,0,0,0,0,0,2],
      [2,0,0,0,0,0,0,0,0,0,0,2],
      [2,0,1,0,0,0,0,0,4,0,0,2],
      [2,0,0,0,0,0,0,0,0,0,0,2],
      [2,0,0,0,0,0,0,0,0,0,0,2],
      [2,2,2,2,2,2,2,2,2,2,2,2]
    ],
    "start_player": [2, 4]
  }
]